50
22222222222222222222222222222222222222222222222222
22122222222222222222122222212222222122222222122222
21111111111112111111111112111211111111121111111112
22121222222212122212222222121212122222221212222212
22121211111212111211111111121112121112111211121212
22121212221212221222222222222222121212122222121212
22121211121211121211121211111112111211121111121112
21121222121222221212121212221222222222221222221222
22121111121112111212121212121111111211111212111212
22122222222212122212121212122222121212222212122212
22111212111112121112111212111211121212111112121112
22221212121222121222222212221212222212121212121212
22111212121211121211111211121212111112121212111212
21122212122212221212221222121212122222121222222212
22111112111112111211121111121212121112121111111112
22222212222222121222122222221212121212122222222222
22121112111111121111111111111212121211121111111112
22121222122222221222222222221212122212222222222212
22121112111211121211121211111212111211121111111112
21122212221212122212121212222212221222121222222212
22111211121212111112121112111111121112121211121212
22122222122212222222122222122222122212121212121212
22111112111112111112121112121211121112111212111212
22122212222222122222121212121212221222222212222212
22111211121111121112111211121112111211111211121112
22221222121212221212221222222222122222122212121222
22121212121211111211111211111112111112111112111212
22121212121222222222222212222212222212122222222212
21121112121112111111111112111211111112121111111112
22122212121222122222222222121222222222122222121222
22111212111211121111111212121111111212111112121112
22122212222212222212221212122222121212222212122212
22111112121112111211121212121112121211121112111212
22122222121212121222121212121212121222121222222212
22121111121212121112121212111212121111121111111212
22121212221222122212121212122222122212222222221212
22121211121211111212121112121112111212111111121212
21121222121212222212122222121212221222122222121212
22121112121112121112111111121211111211121112121112
22122222122222121222222222121222222212221212122212
22111112111111121111111111121111111212111212121112
22222212122222122222222222121222221212221212121222
22111212121211111111121112121112111211111212121112
22121212121212222222122212122212122222122222122212
22121112121212111111121112111212111111121211121112
22122222121212221222221212221222222222221212221222
22111112111211121211111211121111121111121211121112
22222212222222121222122222122222121222121212122212
22111111111111121111121111111112111112111212111112
22222222222222222222222222222222222222222222222222
5
4,1
46,1
4,47
46,47
27,23
